XXXXXXXXXXXXXXXXXXXXXXXX
X XXX       XX X       X
X XXX  XXXX XX X XXXXX X
X     XXXXX X XXXXXXXX X
XXXXXXX     S  X       X
X    X XXXXXX XX  XXXXXX
X XXXX X          X    X
X        XXX XXX    X  X
XXXXXXXXXX     XXXXXX  X
XG          XX        GX
XXXXXXXXXXXXXXXXXXXXXXXX
